OmegaT	OmegaT
has	ha
chosen	scelto
automatically	automaticamente
option	opzione
options	opzioni
none	nessuna
launch	avvio
GUI	interfaccia grafica
only	solo
path	percorso
project	progetto
and	e
load	caricamento
project team	progetto in collaborazione
specified	specifico
details	dettagli
for	per
invoke	invocare
show	mostra
usage information	informazioni sull'uso
download	scarica
an	un
omegat.project file	file omegat.project
from the URL	dall'URL
given	specificato
as	come
load	carica
the	il
specify	specifica
a	un
mode	modo
other	oltre
default	predefinito
see	vedere
below	sotto
Java	Java
from which	da cui
to load	caricare
default settings	impostazioni predefinite
Java .properties file	file Java .properties
use	usare
interface text	testo dell'interfaccia
directory	cartella
read/write	leggere/scrivere
configuration	configurazione
from/to	da/in
do not attempt	non tentare di
to lock	bloccare
project's	del progetto
do not remember	non memorizzare
the last	l'ultima
opened	aperta
in the	nella
file picker	cronologia di apertura file
aisable	disabilita
functionality	funzionalit√†
disable	disabilita
command line stdout	stdout della riga di comando
to	allo
reduce	riduce
output	output
script file	file di script
to be executed	da eseguire
on	in base a
project events	eventi del progetto
